"","Year","czonename","Per_MF2","Per_MF24","Per_MF34","Per_MF5","Per_SFH"
"1",1988,"Bakersfield, CA Metro ",40,161,121,133,2864
"2",1989,"Bakersfield, CA Metro ",18,232,214,153,3918
"3",1990,"Bakersfield, CA Metro ",58,142,84,255,4492
"4",1991,"Bakersfield, CA Metro ",22,206,184,85,3107
"5",1992,"Bakersfield, CA Metro ",52,249,197,266,3851
"6",1993,"Bakersfield, CA Metro ",36,172,136,142,3082
"7",1994,"Bakersfield, CA Metro ",30,305,275,168,2672
"8",1995,"Bakersfield, CA Metro ",8,147,139,455,2702
"9",1996,"Bakersfield, CA Metro ",2,119,117,300,2393
"10",1997,"Bakersfield, CA Metro ",14,51,37,202,2384
"11",1998,"Bakersfield, CA Metro ",48,285,237,143,3025
"12",1999,"Bakersfield, CA Metro ",8,81,73,244,2832
"13",2000,"Bakersfield, CA Metro ",14,55,41,149,2856
"14",2001,"Bakersfield, CA Metro ",16,28,12,136,3473
"15",2002,"Bakersfield, CA Metro ",6,34,28,298,4549
"16",2003,"Bakersfield, CA Metro ",90,209,119,374,5529
"17",2004,"Bakersfield, CA Metro ",114,323,209,479,6653
"18",2005,"Bakersfield, CA Metro ",200,578,378,595,8277
"19",2006,"Bakersfield, CA Metro ",184,962,778,371,6358
"20",2007,"Bakersfield, CA Metro ",388,659,271,280,3669
"21",2008,"Bakersfield, CA Metro ",190,421,231,510,1627
"22",2009,"Bakersfield, CA Metro ",14,21,7,171,1676
"23",2010,"Bakersfield, CA Metro ",28,60,32,547,1313
"24",2011,"Bakersfield, CA Metro ",32,41,9,263,718
"25",2012,"Bakersfield, CA Metro ",24,52,28,367,1465
"26",2013,"Bakersfield, CA Metro ",84,139,55,391,1919
"27",2014,"Bakersfield, CA Metro ",56,96,40,284,1998
"28",2015,"Bakersfield, CA Metro ",26,72,46,85,2020
"29",1988,"Eureka-Arcata-Fortuna, CA Micro ",10,85,75,150,534
"30",1989,"Eureka-Arcata-Fortuna, CA Micro ",16,73,57,195,564
"31",1990,"Eureka-Arcata-Fortuna, CA Micro ",18,103,85,170,667
"32",1991,"Eureka-Arcata-Fortuna, CA Micro ",22,78,56,142,533
"33",1992,"Eureka-Arcata-Fortuna, CA Micro ",16,117,101,37,534
"34",1993,"Eureka-Arcata-Fortuna, CA Micro ",20,74,54,108,547
"35",1994,"Eureka-Arcata-Fortuna, CA Micro ",12,66,54,37,475
"36",1995,"Eureka-Arcata-Fortuna, CA Micro ",6,45,39,55,442
"37",1996,"Eureka-Arcata-Fortuna, CA Micro ",6,16,10,27,385
"38",1997,"Eureka-Arcata-Fortuna, CA Micro ",8,18,10,83,392
"39",1998,"Eureka-Arcata-Fortuna, CA Micro ",2,17,15,20,386
"40",1999,"Eureka-Arcata-Fortuna, CA Micro ",4,27,23,28,395
"41",2000,"Eureka-Arcata-Fortuna, CA Micro ",2,21,19,60,325
"42",2001,"Eureka-Arcata-Fortuna, CA Micro ",10,42,32,118,432
"43",2002,"Eureka-Arcata-Fortuna, CA Micro ",6,56,50,84,440
"44",2003,"Eureka-Arcata-Fortuna, CA Micro ",18,33,15,23,431
"45",2004,"Eureka-Arcata-Fortuna, CA Micro ",22,107,85,8,574
"46",2005,"Eureka-Arcata-Fortuna, CA Micro ",22,42,20,0,521
"47",2006,"Eureka-Arcata-Fortuna, CA Micro ",10,61,51,92,380
"48",2007,"Eureka-Arcata-Fortuna, CA Micro ",6,18,12,53,355
"49",2008,"Eureka-Arcata-Fortuna, CA Micro ",2,38,36,82,237
"50",2009,"Eureka-Arcata-Fortuna, CA Micro ",4,24,20,0,189
"51",2010,"Eureka-Arcata-Fortuna, CA Micro ",4,8,4,16,207
"52",2011,"Eureka-Arcata-Fortuna, CA Micro ",2,42,40,108,172
"53",2012,"Eureka-Arcata-Fortuna, CA Micro ",6,28,22,40,109
"54",2013,"Eureka-Arcata-Fortuna, CA Micro ",6,22,16,14,141
"55",2014,"Eureka-Arcata-Fortuna, CA Micro ",6,31,25,40,177
"56",2015,"Eureka-Arcata-Fortuna, CA Micro ",0,8,8,0,143
"57",1988,"Fresno, CA Metro PLUS",156,647,491,623,5524
"58",1989,"Fresno, CA Metro PLUS",176,762,586,2196,7864
"59",1990,"Fresno, CA Metro PLUS",392,761,369,1262,7647
"60",1991,"Fresno, CA Metro PLUS",150,481,331,870,6727
"61",1992,"Fresno, CA Metro PLUS",180,577,397,743,7301
"62",1993,"Fresno, CA Metro PLUS",120,325,205,419,6506
"63",1994,"Fresno, CA Metro PLUS",118,350,232,881,6669
"64",1995,"Fresno, CA Metro PLUS",126,577,451,1022,5741
"65",1996,"Fresno, CA Metro PLUS",70,244,174,429,5489
"66",1997,"Fresno, CA Metro PLUS",80,225,145,453,4704
"67",1998,"Fresno, CA Metro PLUS",98,198,100,553,5128
"68",1999,"Fresno, CA Metro PLUS",68,256,188,406,5135
"69",2000,"Fresno, CA Metro PLUS",28,197,169,198,5543
"70",2001,"Fresno, CA Metro PLUS",100,283,183,281,6633
"71",2002,"Fresno, CA Metro PLUS",56,206,150,302,7000
"72",2003,"Fresno, CA Metro PLUS",92,612,520,1538,8451
"73",2004,"Fresno, CA Metro PLUS",272,829,557,1443,9939
"74",2005,"Fresno, CA Metro PLUS",238,674,436,1712,12420
"75",2006,"Fresno, CA Metro PLUS",270,659,389,866,8965
"76",2007,"Fresno, CA Metro PLUS",140,482,342,1478,7001
"77",2008,"Fresno, CA Metro PLUS",52,117,65,664,4096
"78",2009,"Fresno, CA Metro PLUS",22,135,113,195,3499
"79",2010,"Fresno, CA Metro PLUS",42,177,135,679,3285
"80",2011,"Fresno, CA Metro PLUS",8,84,76,698,1866
"81",2012,"Fresno, CA Metro PLUS",12,33,21,365,2230
"82",2013,"Fresno, CA Metro PLUS",31,145,114,633,3613
"83",2014,"Fresno, CA Metro PLUS",32,55,23,946,2708
"84",2015,"Fresno, CA Metro PLUS",80,83,3,362,3462
"85",1988,"Los Angeles-Long Beach-Glendale, CA Metro Division",2422,7576,5154,48545,77415
"86",1989,"Los Angeles-Long Beach-Glendale, CA Metro Division",1967,6480,4513,35746,73431
"87",1990,"Los Angeles-Long Beach-Glendale, CA Metro Division",1686,4767,3081,26904,36805
"88",1991,"Los Angeles-Long Beach-Glendale, CA Metro Division",898,3133,2235,13116,24900
"89",1992,"Los Angeles-Long Beach-Glendale, CA Metro Division",700,2688,1988,7093,25233
"90",1993,"Los Angeles-Long Beach-Glendale, CA Metro Division",438,1202,764,4576,22414
"91",1994,"Los Angeles-Long Beach-Glendale, CA Metro Division",462,1311,849,8340,26094
"92",1995,"Los Angeles-Long Beach-Glendale, CA Metro Division",401,1004,603,5094,23672
"93",1996,"Los Angeles-Long Beach-Glendale, CA Metro Division",368,808,440,6578,26294
"94",1997,"Los Angeles-Long Beach-Glendale, CA Metro Division",422,1248,826,8240,30880
"95",1998,"Los Angeles-Long Beach-Glendale, CA Metro Division",458,1056,598,9101,33424
"96",1999,"Los Angeles-Long Beach-Glendale, CA Metro Division",499,1548,1049,12818,38458
"97",2000,"Los Angeles-Long Beach-Glendale, CA Metro Division",707,1694,987,16004,37701
"98",2001,"Los Angeles-Long Beach-Glendale, CA Metro Division",660,1848,1188,15391,40647
"99",2002,"Los Angeles-Long Beach-Glendale, CA Metro Division",759,1928,1169,18605,46638
"100",2003,"Los Angeles-Long Beach-Glendale, CA Metro Division",1186,2575,1389,20604,54081
"101",2004,"Los Angeles-Long Beach-Glendale, CA Metro Division",858,2974,2116,27245,61337
"102",2005,"Los Angeles-Long Beach-Glendale, CA Metro Division",1028,3073,2045,21253,63861
"103",2006,"Los Angeles-Long Beach-Glendale, CA Metro Division",1260,3014,1754,24566,48683
"104",2007,"Los Angeles-Long Beach-Glendale, CA Metro Division",886,2503,1617,20807,26429
"105",2008,"Los Angeles-Long Beach-Glendale, CA Metro Division",648,1284,636,14538,10984
"106",2009,"Los Angeles-Long Beach-Glendale, CA Metro Division",542,959,417,5373,8610
"107",2010,"Los Angeles-Long Beach-Glendale, CA Metro Division",390,947,557,7193,9413
"108",2011,"Los Angeles-Long Beach-Glendale, CA Metro Division",444,829,385,12124,8180
"109",2012,"Los Angeles-Long Beach-Glendale, CA Metro Division",467,892,425,13380,10367
"110",2013,"Los Angeles-Long Beach-Glendale, CA Metro Division",784,1331,547,20392,14635
"111",2014,"Los Angeles-Long Beach-Glendale, CA Metro Division",754,1493,739,23156,14756
"112",2015,"Los Angeles-Long Beach-Glendale, CA Metro Division",987,2291,1304,25006,14080
"113",1988,"Merced, Modesto Metro PLUS",162,419,257,634,6052
"114",1989,"Merced, Modesto Metro PLUS",204,469,265,960,7499
"115",1990,"Merced, Modesto Metro PLUS",114,384,270,362,5404
"116",1991,"Merced, Modesto Metro PLUS",72,249,177,293,2788
"117",1992,"Merced, Modesto Metro PLUS",62,108,46,47,3973
"118",1993,"Merced, Modesto Metro PLUS",30,140,110,32,3280
"119",1994,"Merced, Modesto Metro PLUS",44,82,38,12,2755
"120",1995,"Merced, Modesto Metro PLUS",28,73,45,106,2330
"121",1996,"Merced, Modesto Metro PLUS",22,115,93,67,2398
"122",1997,"Merced, Modesto Metro PLUS",20,62,42,237,2487
"123",1998,"Merced, Modesto Metro PLUS",34,41,7,276,3289
"124",1999,"Merced, Modesto Metro PLUS",8,24,16,40,3517
"125",2000,"Merced, Modesto Metro PLUS",18,41,23,363,4925
"126",2001,"Merced, Modesto Metro PLUS",90,168,78,87,4418
"127",2002,"Merced, Modesto Metro PLUS",70,216,146,59,4948
"128",2003,"Merced, Modesto Metro PLUS",72,232,160,513,6862
"129",2004,"Merced, Modesto Metro PLUS",48,100,52,483,7170
"130",2005,"Merced, Modesto Metro PLUS",42,131,89,333,8547
"131",2006,"Merced, Modesto Metro PLUS",52,158,106,61,4746
"132",2007,"Merced, Modesto Metro PLUS",60,97,37,461,2201
"133",2008,"Merced, Modesto Metro PLUS",124,127,3,121,871
"134",2009,"Merced, Modesto Metro PLUS",0,0,0,85,410
"135",2010,"Merced, Modesto Metro PLUS",6,14,8,124,376
"136",2011,"Merced, Modesto Metro PLUS",2,16,14,107,277
"137",2012,"Merced, Modesto Metro PLUS",4,20,16,164,296
"138",2013,"Merced, Modesto Metro PLUS",2,2,0,89,475
"139",2014,"Merced, Modesto Metro PLUS",6,10,4,50,640
"140",2015,"Merced, Modesto Metro PLUS",2,6,4,8,842
"141",1988,"Redding, CA Metro Red Bluff Micro, CA Micro ",42,125,83,85,1256
"142",1989,"Redding, CA Metro Red Bluff Micro, CA Micro ",100,232,132,98,1521
"143",1990,"Redding, CA Metro Red Bluff Micro, CA Micro ",94,239,145,282,2166
"144",1991,"Redding, CA Metro Red Bluff Micro, CA Micro ",56,100,44,114,1340
"145",1992,"Redding, CA Metro Red Bluff Micro, CA Micro ",36,124,88,0,1273
"146",1993,"Redding, CA Metro Red Bluff Micro, CA Micro ",50,208,158,24,1280
"147",1994,"Redding, CA Metro Red Bluff Micro, CA Micro ",80,107,27,7,1110
"148",1995,"Redding, CA Metro Red Bluff Micro, CA Micro ",68,130,62,56,819
"149",1996,"Redding, CA Metro Red Bluff Micro, CA Micro ",34,89,55,61,720
"150",1997,"Redding, CA Metro Red Bluff Micro, CA Micro ",18,66,48,0,705
"151",1998,"Redding, CA Metro Red Bluff Micro, CA Micro ",0,40,40,25,783
"152",1999,"Redding, CA Metro Red Bluff Micro, CA Micro ",6,66,60,0,898
"153",2000,"Redding, CA Metro Red Bluff Micro, CA Micro ",12,98,86,166,929
"154",2001,"Redding, CA Metro Red Bluff Micro, CA Micro ",6,10,4,11,1186
"155",2002,"Redding, CA Metro Red Bluff Micro, CA Micro ",6,94,88,91,1462
"156",2003,"Redding, CA Metro Red Bluff Micro, CA Micro ",36,66,30,221,1481
"157",2004,"Redding, CA Metro Red Bluff Micro, CA Micro ",8,27,19,136,1516
"158",2005,"Redding, CA Metro Red Bluff Micro, CA Micro ",56,119,63,149,1966
"159",2006,"Redding, CA Metro Red Bluff Micro, CA Micro ",38,135,97,224,1118
"160",2007,"Redding, CA Metro Red Bluff Micro, CA Micro ",26,77,51,188,786
"161",2008,"Redding, CA Metro Red Bluff Micro, CA Micro ",6,22,16,156,454
"162",2009,"Redding, CA Metro Red Bluff Micro, CA Micro ",14,26,12,0,295
"163",2010,"Redding, CA Metro Red Bluff Micro, CA Micro ",54,63,9,21,228
"164",2011,"Redding, CA Metro Red Bluff Micro, CA Micro ",2,15,13,26,142
"165",2012,"Redding, CA Metro Red Bluff Micro, CA Micro ",7,18,11,2,229
"166",2013,"Redding, CA Metro Red Bluff Micro, CA Micro ",0,0,0,0,244
"167",2014,"Redding, CA Metro Red Bluff Micro, CA Micro ",6,9,3,0,298
"168",2015,"Redding, CA Metro Red Bluff Micro, CA Micro ",4,4,0,0,326
"169",1988,"Sacramento--Arden-Arcade--Roseville, CA Metro ",216,470,254,4897,19496
"170",1989,"Sacramento--Arden-Arcade--Roseville, CA Metro ",194,470,276,4148,22700
"171",1990,"Sacramento--Arden-Arcade--Roseville, CA Metro ",214,338,124,2883,18635
"172",1991,"Sacramento--Arden-Arcade--Roseville, CA Metro ",224,540,316,2051,11402
"173",1992,"Sacramento--Arden-Arcade--Roseville, CA Metro ",122,281,159,1226,11873
"174",1993,"Sacramento--Arden-Arcade--Roseville, CA Metro ",122,192,70,820,11739
"175",1994,"Sacramento--Arden-Arcade--Roseville, CA Metro ",92,422,330,681,12149
"176",1995,"Sacramento--Arden-Arcade--Roseville, CA Metro ",46,280,234,644,10668
"177",1996,"Sacramento--Arden-Arcade--Roseville, CA Metro ",54,99,45,1099,11193
"178",1997,"Sacramento--Arden-Arcade--Roseville, CA Metro ",54,118,64,1682,11677
"179",1998,"Sacramento--Arden-Arcade--Roseville, CA Metro ",96,354,258,3752,15122
"180",1999,"Sacramento--Arden-Arcade--Roseville, CA Metro ",62,187,125,3974,16847
"181",2000,"Sacramento--Arden-Arcade--Roseville, CA Metro ",62,353,291,3023,20431
"182",2001,"Sacramento--Arden-Arcade--Roseville, CA Metro ",74,308,234,3954,20562
"183",2002,"Sacramento--Arden-Arcade--Roseville, CA Metro ",130,359,229,4995,26113
"184",2003,"Sacramento--Arden-Arcade--Roseville, CA Metro ",266,401,135,4664,26707
"185",2004,"Sacramento--Arden-Arcade--Roseville, CA Metro ",322,590,268,3887,27049
"186",2005,"Sacramento--Arden-Arcade--Roseville, CA Metro ",314,691,377,2616,23504
"187",2006,"Sacramento--Arden-Arcade--Roseville, CA Metro ",192,476,284,3445,13445
"188",2007,"Sacramento--Arden-Arcade--Roseville, CA Metro ",148,332,184,1566,9960
"189",2008,"Sacramento--Arden-Arcade--Roseville, CA Metro ",28,49,21,1774,5156
"190",2009,"Sacramento--Arden-Arcade--Roseville, CA Metro ",10,45,35,391,3335
"191",2010,"Sacramento--Arden-Arcade--Roseville, CA Metro ",6,36,30,694,3166
"192",2011,"Sacramento--Arden-Arcade--Roseville, CA Metro ",4,14,10,841,2785
"193",2012,"Sacramento--Arden-Arcade--Roseville, CA Metro ",22,44,22,572,4155
"194",2013,"Sacramento--Arden-Arcade--Roseville, CA Metro ",33,40,7,1001,4953
"195",2014,"Sacramento--Arden-Arcade--Roseville, CA Metro ",25,57,32,696,5254
"196",2015,"Sacramento--Arden-Arcade--Roseville, CA Metro ",247,491,244,775,6357
"197",1988,"San Diego-Carlsbad-San Marcos, CA Metro ",490,1464,974,12339,14749
"198",1989,"San Diego-Carlsbad-San Marcos, CA Metro ",428,1123,695,6731,10856
"199",1990,"San Diego-Carlsbad-San Marcos, CA Metro ",546,1127,581,8048,6621
"200",1991,"San Diego-Carlsbad-San Marcos, CA Metro ",240,833,593,1733,5342
"201",1992,"San Diego-Carlsbad-San Marcos, CA Metro ",140,514,374,1783,3762
"202",1993,"San Diego-Carlsbad-San Marcos, CA Metro ",126,384,258,1142,4076
"203",1994,"San Diego-Carlsbad-San Marcos, CA Metro ",100,634,534,1054,5247
"204",1995,"San Diego-Carlsbad-San Marcos, CA Metro ",80,510,430,1362,4736
"205",1996,"San Diego-Carlsbad-San Marcos, CA Metro ",90,561,471,491,5816
"206",1997,"San Diego-Carlsbad-San Marcos, CA Metro ",156,595,439,2469,8338
"207",1998,"San Diego-Carlsbad-San Marcos, CA Metro ",114,664,550,2349,9160
"208",1999,"San Diego-Carlsbad-San Marcos, CA Metro ",62,396,334,6038,9993
"209",2000,"San Diego-Carlsbad-San Marcos, CA Metro ",106,721,615,6039,9167
"210",2001,"San Diego-Carlsbad-San Marcos, CA Metro ",80,516,436,5810,9312
"211",2002,"San Diego-Carlsbad-San Marcos, CA Metro ",344,1025,681,4964,9749
"212",2003,"San Diego-Carlsbad-San Marcos, CA Metro ",246,1545,1299,7314,9455
"213",2004,"San Diego-Carlsbad-San Marcos, CA Metro ",290,1514,1224,6237,9555
"214",2005,"San Diego-Carlsbad-San Marcos, CA Metro ",212,852,640,6502,7904
"215",2006,"San Diego-Carlsbad-San Marcos, CA Metro ",176,585,409,5439,4753
"216",2007,"San Diego-Carlsbad-San Marcos, CA Metro ",154,482,328,3460,3503
"217",2008,"San Diego-Carlsbad-San Marcos, CA Metro ",64,162,98,2640,2352
"218",2009,"San Diego-Carlsbad-San Marcos, CA Metro ",50,115,65,1089,1786
"219",2010,"San Diego-Carlsbad-San Marcos, CA Metro ",48,191,143,901,2254
"220",2011,"San Diego-Carlsbad-San Marcos, CA Metro ",52,168,116,2800,2252
"221",2012,"San Diego-Carlsbad-San Marcos, CA Metro ",137,505,368,3814,2100
"222",2013,"San Diego-Carlsbad-San Marcos, CA Metro ",85,301,216,6068,2519
"223",2014,"San Diego-Carlsbad-San Marcos, CA Metro ",75,303,228,4026,2257
"224",2015,"San Diego-Carlsbad-San Marcos, CA Metro ",68,284,216,5935,2888
"225",1988,"San Francisco-San Mateo-Redwood City, CA Metro Division",448,1241,793,8090,17314
"226",1989,"San Francisco-San Mateo-Redwood City, CA Metro Division",518,1186,668,8124,16929
"227",1990,"San Francisco-San Mateo-Redwood City, CA Metro Division",288,991,703,3690,8330
"228",1991,"San Francisco-San Mateo-Redwood City, CA Metro Division",264,586,322,3648,6800
"229",1992,"San Francisco-San Mateo-Redwood City, CA Metro Division",218,604,386,2253,8209
"230",1993,"San Francisco-San Mateo-Redwood City, CA Metro Division",156,290,134,1914,7492
"231",1994,"San Francisco-San Mateo-Redwood City, CA Metro Division",158,467,309,1806,8818
"232",1995,"San Francisco-San Mateo-Redwood City, CA Metro Division",186,626,440,1682,7944
"233",1996,"San Francisco-San Mateo-Redwood City, CA Metro Division",360,839,479,3036,8869
"234",1997,"San Francisco-San Mateo-Redwood City, CA Metro Division",249,753,504,4351,10640
"235",1998,"San Francisco-San Mateo-Redwood City, CA Metro Division",294,826,532,6315,10916
"236",1999,"San Francisco-San Mateo-Redwood City, CA Metro Division",286,674,388,5842,10705
"237",2000,"San Francisco-San Mateo-Redwood City, CA Metro Division",174,812,638,7009,11222
"238",2001,"San Francisco-San Mateo-Redwood City, CA Metro Division",238,531,293,5578,9365
"239",2002,"San Francisco-San Mateo-Redwood City, CA Metro Division",246,625,379,4788,10812
"240",2003,"San Francisco-San Mateo-Redwood City, CA Metro Division",285,551,266,6550,11239
"241",2004,"San Francisco-San Mateo-Redwood City, CA Metro Division",282,895,613,7878,10853
"242",2005,"San Francisco-San Mateo-Redwood City, CA Metro Division",114,490,376,7066,10470
"243",2006,"San Francisco-San Mateo-Redwood City, CA Metro Division",126,401,275,8706,7035
"244",2007,"San Francisco-San Mateo-Redwood City, CA Metro Division",196,389,193,5804,5986
"245",2008,"San Francisco-San Mateo-Redwood City, CA Metro Division",126,232,106,5294,2795
"246",2009,"San Francisco-San Mateo-Redwood City, CA Metro Division",76,167,91,1310,2847
"247",2010,"San Francisco-San Mateo-Redwood City, CA Metro Division",64,176,112,2510,2579
"248",2011,"San Francisco-San Mateo-Redwood City, CA Metro Division",76,151,75,4130,2294
"249",2012,"San Francisco-San Mateo-Redwood City, CA Metro Division",295,644,349,5758,3271
"250",2013,"San Francisco-San Mateo-Redwood City, CA Metro Division",67,232,165,9181,4092
"251",2014,"San Francisco-San Mateo-Redwood City, CA Metro Division",122,242,120,6945,3724
"252",2015,"San Francisco-San Mateo-Redwood City, CA Metro Division",140,352,212,7568,4826
"253",1988,"San Jose-Sunnyvale-Santa Clara, CA Metro ",128,517,389,3006,6060
"254",1989,"San Jose-Sunnyvale-Santa Clara, CA Metro ",156,402,246,2640,5546
"255",1990,"San Jose-Sunnyvale-Santa Clara, CA Metro ",198,439,241,3752,3347
"256",1991,"San Jose-Sunnyvale-Santa Clara, CA Metro ",146,424,278,2016,2834
"257",1992,"San Jose-Sunnyvale-Santa Clara, CA Metro ",74,118,44,1587,2868
"258",1993,"San Jose-Sunnyvale-Santa Clara, CA Metro ",96,307,211,1515,3235
"259",1994,"San Jose-Sunnyvale-Santa Clara, CA Metro ",92,400,308,1717,4303
"260",1995,"San Jose-Sunnyvale-Santa Clara, CA Metro ",72,258,186,1380,4094
"261",1996,"San Jose-Sunnyvale-Santa Clara, CA Metro ",50,425,375,3521,6030
"262",1997,"San Jose-Sunnyvale-Santa Clara, CA Metro ",130,405,275,4623,6876
"263",1998,"San Jose-Sunnyvale-Santa Clara, CA Metro ",114,365,251,3459,6264
"264",1999,"San Jose-Sunnyvale-Santa Clara, CA Metro ",74,276,202,4112,5790
"265",2000,"San Jose-Sunnyvale-Santa Clara, CA Metro ",72,370,298,4225,5289
"266",2001,"San Jose-Sunnyvale-Santa Clara, CA Metro ",58,296,238,4437,3233
"267",2002,"San Jose-Sunnyvale-Santa Clara, CA Metro ",81,270,189,2875,3661
"268",2003,"San Jose-Sunnyvale-Santa Clara, CA Metro ",94,222,128,5818,4135
"269",2004,"San Jose-Sunnyvale-Santa Clara, CA Metro ",116,327,211,2745,4625
"270",2005,"San Jose-Sunnyvale-Santa Clara, CA Metro ",62,331,269,3383,4513
"271",2006,"San Jose-Sunnyvale-Santa Clara, CA Metro ",34,161,127,4070,3340
"272",2007,"San Jose-Sunnyvale-Santa Clara, CA Metro ",56,122,66,3297,2891
"273",2008,"San Jose-Sunnyvale-Santa Clara, CA Metro ",64,180,116,2469,1721
"274",2009,"San Jose-Sunnyvale-Santa Clara, CA Metro ",44,82,38,465,932
"275",2010,"San Jose-Sunnyvale-Santa Clara, CA Metro ",10,72,62,3842,1084
"276",2011,"San Jose-Sunnyvale-Santa Clara, CA Metro ",14,109,95,2263,1224
"277",2012,"San Jose-Sunnyvale-Santa Clara, CA Metro ",40,129,89,4291,1714
"278",2013,"San Jose-Sunnyvale-Santa Clara, CA Metro ",70,190,120,5703,2178
"279",2014,"San Jose-Sunnyvale-Santa Clara, CA Metro ",36,440,404,7998,1991
"280",2015,"San Jose-Sunnyvale-Santa Clara, CA Metro ",28,130,102,3092,1996
"281",1988,"Santa Barbara, San Luis Obispo-Paso Robles, CA Metro ",122,330,208,166,3538
"282",1989,"Santa Barbara, San Luis Obispo-Paso Robles, CA Metro ",84,216,132,136,3742
"283",1990,"Santa Barbara, San Luis Obispo-Paso Robles, CA Metro ",128,257,129,322,2161
"284",1991,"Santa Barbara, San Luis Obispo-Paso Robles, CA Metro ",48,90,42,339,1625
"285",1992,"Santa Barbara, San Luis Obispo-Paso Robles, CA Metro ",100,125,25,103,1157
"286",1993,"Santa Barbara, San Luis Obispo-Paso Robles, CA Metro ",18,39,21,93,1272
"287",1994,"Santa Barbara, San Luis Obispo-Paso Robles, CA Metro ",36,105,69,70,1572
"288",1995,"Santa Barbara, San Luis Obispo-Paso Robles, CA Metro ",53,97,44,158,1522
"289",1996,"Santa Barbara, San Luis Obispo-Paso Robles, CA Metro ",91,114,23,37,1800
"290",1997,"Santa Barbara, San Luis Obispo-Paso Robles, CA Metro ",36,77,41,348,1807
"291",1998,"Santa Barbara, San Luis Obispo-Paso Robles, CA Metro ",72,119,47,159,2478
"292",1999,"Santa Barbara, San Luis Obispo-Paso Robles, CA Metro ",60,121,61,279,2179
"293",2000,"Santa Barbara, San Luis Obispo-Paso Robles, CA Metro ",30,185,155,111,2278
"294",2001,"Santa Barbara, San Luis Obispo-Paso Robles, CA Metro ",46,152,106,364,2622
"295",2002,"Santa Barbara, San Luis Obispo-Paso Robles, CA Metro ",60,180,120,849,2675
"296",2003,"Santa Barbara, San Luis Obispo-Paso Robles, CA Metro ",64,183,119,473,3183
"297",2004,"Santa Barbara, San Luis Obispo-Paso Robles, CA Metro ",90,353,263,566,2861
"298",2005,"Santa Barbara, San Luis Obispo-Paso Robles, CA Metro ",152,238,86,355,2312
"299",2006,"Santa Barbara, San Luis Obispo-Paso Robles, CA Metro ",124,323,199,245,1924
"300",2007,"Santa Barbara, San Luis Obispo-Paso Robles, CA Metro ",48,175,127,363,1209
"301",2008,"Santa Barbara, San Luis Obispo-Paso Robles, CA Metro ",40,53,13,452,635
"302",2009,"Santa Barbara, San Luis Obispo-Paso Robles, CA Metro ",10,34,24,60,492
"303",2010,"Santa Barbara, San Luis Obispo-Paso Robles, CA Metro ",14,38,24,314,537
"304",2011,"Santa Barbara, San Luis Obispo-Paso Robles, CA Metro ",62,155,93,63,422
"305",2012,"Santa Barbara, San Luis Obispo-Paso Robles, CA Metro ",16,73,57,273,596
"306",2013,"Santa Barbara, San Luis Obispo-Paso Robles, CA Metro ",12,48,36,245,845
"307",2014,"Santa Barbara, San Luis Obispo-Paso Robles, CA Metro ",35,58,23,725,1082
"308",2015,"Santa Barbara, San Luis Obispo-Paso Robles, CA Metro ",36,136,100,715,917
"309",1988,"Santa Rosa-Petaluma, CA Metro ",90,206,116,777,4457
"310",1989,"Santa Rosa-Petaluma, CA Metro ",76,131,55,966,4534
"311",1990,"Santa Rosa-Petaluma, CA Metro ",68,136,68,940,3662
"312",1991,"Santa Rosa-Petaluma, CA Metro ",56,183,127,38,2956
"313",1992,"Santa Rosa-Petaluma, CA Metro ",42,65,23,133,2549
"314",1993,"Santa Rosa-Petaluma, CA Metro ",48,109,61,185,2254
"315",1994,"Santa Rosa-Petaluma, CA Metro ",46,160,114,196,2575
"316",1995,"Santa Rosa-Petaluma, CA Metro ",52,132,80,262,1982
"317",1996,"Santa Rosa-Petaluma, CA Metro ",32,48,16,61,1696
"318",1997,"Santa Rosa-Petaluma, CA Metro ",64,88,24,377,2083
"319",1998,"Santa Rosa-Petaluma, CA Metro ",88,118,30,870,2326
"320",1999,"Santa Rosa-Petaluma, CA Metro ",42,108,66,589,2790
"321",2000,"Santa Rosa-Petaluma, CA Metro ",136,248,112,350,2419
"322",2001,"Santa Rosa-Petaluma, CA Metro ",150,186,36,792,2072
"323",2002,"Santa Rosa-Petaluma, CA Metro ",78,131,53,544,1931
"324",2003,"Santa Rosa-Petaluma, CA Metro ",66,161,95,918,2182
"325",2004,"Santa Rosa-Petaluma, CA Metro ",118,132,14,609,2182
"326",2005,"Santa Rosa-Petaluma, CA Metro ",68,143,75,1246,2423
"327",2006,"Santa Rosa-Petaluma, CA Metro ",34,93,59,641,2125
"328",2007,"Santa Rosa-Petaluma, CA Metro ",74,123,49,581,1459
"329",2008,"Santa Rosa-Petaluma, CA Metro ",20,44,24,28,810
"330",2009,"Santa Rosa-Petaluma, CA Metro ",2,2,0,71,528
"331",2010,"Santa Rosa-Petaluma, CA Metro ",0,19,19,206,448
"332",2011,"Santa Rosa-Petaluma, CA Metro ",6,36,30,136,575
"333",2012,"Santa Rosa-Petaluma, CA Metro ",10,16,6,352,382
"334",2013,"Santa Rosa-Petaluma, CA Metro ",16,16,0,745,424
"335",2014,"Santa Rosa-Petaluma, CA Metro ",10,21,11,200,367
"336",2015,"Santa Rosa-Petaluma, CA Metro ",28,66,38,144,351
"337",1988,"Yuba City-Marysville, CA PLUS ",38,157,119,205,1641
"338",1989,"Yuba City-Marysville, CA PLUS ",180,311,131,323,2285
"339",1990,"Yuba City-Marysville, CA PLUS ",102,350,248,777,2419
"340",1991,"Yuba City-Marysville, CA PLUS ",88,209,121,426,2004
"341",1992,"Yuba City-Marysville, CA PLUS ",94,153,59,14,1966
"342",1993,"Yuba City-Marysville, CA PLUS ",38,78,40,108,1665
"343",1994,"Yuba City-Marysville, CA PLUS ",30,43,13,212,1375
"344",1995,"Yuba City-Marysville, CA PLUS ",22,107,85,39,1208
"345",1996,"Yuba City-Marysville, CA PLUS ",8,43,35,27,1040
"346",1997,"Yuba City-Marysville, CA PLUS ",18,30,12,34,1064
"347",1998,"Yuba City-Marysville, CA PLUS ",12,16,4,144,1212
"348",1999,"Yuba City-Marysville, CA PLUS ",2,21,19,134,1311
"349",2000,"Yuba City-Marysville, CA PLUS ",4,4,0,169,1326
"350",2001,"Yuba City-Marysville, CA PLUS ",38,54,16,23,1726
"351",2002,"Yuba City-Marysville, CA PLUS ",28,61,33,0,2271
"352",2003,"Yuba City-Marysville, CA PLUS ",20,89,69,539,3143
"353",2004,"Yuba City-Marysville, CA PLUS ",58,178,120,372,4783
"354",2005,"Yuba City-Marysville, CA PLUS ",128,224,96,32,4834
"355",2006,"Yuba City-Marysville, CA PLUS ",18,52,34,86,2786
"356",2007,"Yuba City-Marysville, CA PLUS ",22,57,35,336,1765
"357",2008,"Yuba City-Marysville, CA PLUS ",8,37,29,85,783
"358",2009,"Yuba City-Marysville, CA PLUS ",4,8,4,120,498
"359",2010,"Yuba City-Marysville, CA PLUS ",0,58,58,292,369
"360",2011,"Yuba City-Marysville, CA PLUS ",2,42,40,103,296
"361",2012,"Yuba City-Marysville, CA PLUS ",0,14,14,90,342
"362",2013,"Yuba City-Marysville, CA PLUS ",16,44,28,247,565
"363",2014,"Yuba City-Marysville, CA PLUS ",108,125,17,281,603
"364",2015,"Yuba City-Marysville, CA PLUS ",26,82,56,256,656
"365",1988,"Yuma, AZ Metro El Centro Metro",20,101,81,70,451
"366",1989,"Yuma, AZ Metro El Centro Metro",8,70,62,227,474
"367",1990,"Yuma, AZ Metro El Centro Metro",4,75,71,512,500
"368",1991,"Yuma, AZ Metro El Centro Metro",10,36,26,73,680
"369",1992,"Yuma, AZ Metro El Centro Metro",4,69,65,100,832
"370",1993,"Yuma, AZ Metro El Centro Metro",10,47,37,50,529
"371",1994,"Yuma, AZ Metro El Centro Metro",12,60,48,136,658
"372",1995,"Yuma, AZ Metro El Centro Metro",6,43,37,107,347
"373",1996,"Yuma, AZ Metro El Centro Metro",8,30,22,0,301
"374",1997,"Yuma, AZ Metro El Centro Metro",2,19,17,40,268
"375",1998,"Yuma, AZ Metro El Centro Metro",2,9,7,58,327
"376",1999,"Yuma, AZ Metro El Centro Metro",0,6,6,0,327
"377",2000,"Yuma, AZ Metro El Centro Metro",2,5,3,129,543
"378",2001,"Yuma, AZ Metro El Centro Metro",6,26,20,172,558
"379",2002,"Yuma, AZ Metro El Centro Metro",12,38,26,186,838
"380",2003,"Yuma, AZ Metro El Centro Metro",8,30,22,204,977
"381",2004,"Yuma, AZ Metro El Centro Metro",12,41,29,786,1330
"382",2005,"Yuma, AZ Metro El Centro Metro",16,57,41,195,2722
"383",2006,"Yuma, AZ Metro El Centro Metro",10,60,50,159,1631
"384",2007,"Yuma, AZ Metro El Centro Metro",14,35,21,374,670
"385",2008,"Yuma, AZ Metro El Centro Metro",0,8,8,223,233
"386",2009,"Yuma, AZ Metro El Centro Metro",2,6,4,6,183
"387",2010,"Yuma, AZ Metro El Centro Metro",0,0,0,0,102
"388",2011,"Yuma, AZ Metro El Centro Metro",2,2,0,128,144
"389",2012,"Yuma, AZ Metro El Centro Metro",0,0,0,124,215
"390",2013,"Yuma, AZ Metro El Centro Metro",0,0,0,0,326
"391",2014,"Yuma, AZ Metro El Centro Metro",2,5,3,54,177
"392",2015,"Yuma, AZ Metro El Centro Metro",2,6,4,86,107
"393",1988,NA,28,95,67,78,816
"394",1989,NA,46,66,20,230,788
"395",1990,NA,40,160,120,66,963
"396",1991,NA,10,18,8,0,771
"397",1992,NA,10,43,33,0,806
"398",1993,NA,12,52,40,8,530
"399",1994,NA,44,103,59,0,643
"400",1995,NA,66,85,19,68,482
"401",1996,NA,6,14,8,62,499
"402",1997,NA,2,22,20,20,475
"403",1998,NA,52,77,25,0,458
"404",1999,NA,20,56,36,75,534
"405",2000,NA,4,64,60,82,641
"406",2001,NA,2,12,10,241,663
"407",2002,NA,16,27,11,6,778
"408",2003,NA,40,76,36,182,906
"409",2004,NA,36,90,54,189,990
"410",2005,NA,22,54,32,516,1048
"411",2006,NA,30,45,15,103,732
"412",2007,NA,14,26,12,0,525
"413",2008,NA,8,22,14,80,296
"414",2009,NA,4,7,3,0,174
"415",2010,NA,0,0,0,38,165
"416",2011,NA,4,4,0,56,191
"417",2012,NA,16,19,3,1,87
"418",2013,NA,2,6,4,4,97
"419",2014,NA,2,2,0,0,105
"420",2015,NA,6,16,10,0,167
